24
14
OOOOOOOOOOOOOOOOOOOOOOOO
OOOOOOOOOOOOOOOOOOOOOOOO
OOOOOOOOOOOOOOOOOOOOOOOO
                        
                        
              ..        
             .  .       
              !!    B    
    ..      OOOOOOOOOOOO
   .  .    OOOOOOOOOOOOO
 A  !!  O OOOOOOOOOOOOOO
OOOOOOOOOOOOOOOOOOOOOOOO
OOOOOOOOOOOOOOOOOOOOOOOO
OOOOOOOOOOOOOOOOOOOOOOOO
OOOOOOOOOOOOOOOOOOOOOOOO
