24
14
OOOOOOOOOOOOOOOOOOOOOOOO
OOOOOOOOOOOOOOOOOOOOOOOO
OOOOOOOOOOOOOOOOOOOOOOOO
                        
    '    ...       '    
 / M ^  .   . ^  O   A  
OOOOOOOOO  <OOOOOOOOOOOO
OOOOOOOOO>  OOOOOOOOOOOO
OOOOOOOOO   OOOOOOOOOOOO
      |                 
      |   '         '   
 B    |      M  O  ^^   
OOOOOOOOOOOOOOOOOOOOOOOO
OOOOOOOOOOOOOOOOOOOOOOOO
