24
14
OOOOOOOOOOOOOOOOOOOOOOOO
OOOOOOOOOOOOOOOOOOOOOOOO
OOOOOOOOOOOOOOOOOOOOOOOO
                   |    
    ..             |    
 / .  .      '     |    
OOOO>   O  M       | B  
OOOO  OOOOOOOOO . OOOOOO
OOOO <OOOOOOOO . OOOOOOO
     <OOOOOOO . OOOOOOOO
   '         . OOOOOOOOO
 A     ^..^   OOOOOOOOOO
OOO  OOOOOOOOOOOOOOOOOOO
OOO  OOOOOOOOOOOOOOOOOOO
