24
14
OOOOOOOOOOOOOOOOOOOOOOOO
OOOOOOOOOOOOOOOOOOOOOOOO
OOOOOOOOOOOOOOOOOOOOOOOO
                        
                        
                        
                        
               ..       
    ¤  ..     .  .    ¤ 
  A   .  .    O     B   
OOOOOOO     OOO  OOOOOOO
OOOOOOO  OOOOOO  OOOOOOO
OOOOOOO  OOOOOO  OOOOOOO
OOOOOOO  OOOOOO  OOOOOOO
