24
14
OOOOOOOOOOOOOOOOOOOOOOOO
OOOOOOOOOOOOOOOOOOOOOOOO
OOOOOOOOOOOOOOOOOOOOOOOO
                        
    '    ...            
  A  ^  .   .  ^^  M  ^ 
OOOOOOOOO   OOOOOOOOOOOO
OOOOOOOOO>  OOOOOOOOOOOO
OOOOOOOOO   OOOOOOOOOOOO
  v             vv |    
   ...        '    |    
 /.   .^O   ^M  O  | B  
OOOLLLOOOOOOOOOOOOOOOOOO
OOOLLLOOOOOOOOOOOOOOOOOO
