24
14
OOOOOOOOOOOOOOOOOOOOOOOO
OOOOOOOOOOOOOOOOOOOOOOOO
OOOOOOOOOOOOOOOOOOOOOOOO
 v    vv       vv       
   ' ...   ...   ...    
O/ M ^^ M ^  O   M    ' 
OOOOOOOOOOOOOOOOOOOOO   
OOOOOOOOOOOOOOOOOOOv . O
OOOOOOOOOOOOOOOOOO  .<OO
    | vv      v    . OOO
    |   '  ...  ' .<OOOO
 B  | O   ^ A^     OOOOO
OOOOOOOOLLOOOOOLLLOOOOOO
OOOOOOOOLLOOOOOLLLOOOOOO
