24
14
OOOOOOOOOOOOOOOOOOOOOOOO
OOOOOOOOOOOOOOOOOOOOOOOO
OOOOOOOOOOOOOOOOOOOOOOOO
                        
       '            '   
    M^   O ^   ...    A 
  OOOOOOOOOOO       OOOO
  OOOOOOOOOOO> OOO> OOOO
  OOOOOOOOOOO  OOO  OOOO
  OOOOOO      <OOO  |   
  OOOOO     '       |   
 / ...  M ^     ... | B 
OOOOOOOOOOOO   OOOOOOOOO
OOOOOOOOOOOO   OOOOOOOOO
