24
14
OOOOOOOOOOOOOOOOOOOOOOOO
OOOOOOOOOOOOOOOOOOOOOOOO
OOOOOOOOOOOOOOOOOOOOOOOO
                        
 '        ...     '     
   /   O .   .  M    A  
OOOOOOOOOO   OOOOOOOOOOO
OOOOOOOOOO  <OOOOOOOOOOO
OOOOOOOOOO   OOOOOOOOOOO
OOOOOOOOOO         |    
OOOOOOOOOO>    ..  |    
OOOOOOOOOO    .  . | B  
OOOOOOOOOOOOOOOLLOOOOOOO
OOOOOOOOOOOOOOOLLOOOOOOO
