24
14
OOOOOOOOOOOOOOOOOOOOOOOO
OOOOOOOOOOOOOOOOOOOOOOOO
OOOOOOOOOOOOOOOOOOOOOOOO
                        
                  ..    
                 .  .   
                  ^^  A 
 B     ..  ..   OOOOOOOO
OOOO     M      OOOOOOOO
OOOO  OOOOOOOO  OOOOOOOO
OOOO  OOOOOOOO  OOOOOOOO
OOOO  OOOOOOOO  OOOOOOOO
OOOO  OOOOOOOO  OOOOOOOO
OOOO  OOOOOOOO  OOOOOOOO
