24
14
OOOOOOOOOOOOOOOOOOOOOOOO
OOOOOOOOOOOOOOOOOOOOOOOO
OOOOOOOOOOOOOOOOOOOOOOOO
                        
      ...     ...       
      ^^   A O !        
OO . OOOOOOOOOOOOO      
OO .<OOOOOOOOOOOOOO   ' 
OO . OOOOOOOOOOOOOOO    
          |    OOOOOO / 
       '  |    OOOOOOOOO
  M   ^   | B  OOOOOOOOO
OOOOOOOOOOOOOOOOOOOOOOOO
OOOOOOOOOOOOOOOOOOOOOOOO
